{
"islands": [
	{
		"deep_tiles": [
			0, 20, 6, 28, 21, 28, 25, 1, 3, 7, 5, 5, 19, 29, 24, 27, 31, 5, 30, 23, 25, 26, 31, 22, 16, 29, 24, 1, 22, 28, 2, 27, 27, 1, 8, 2, 32, 15, 4, 5, 11, 0, 15, 29, 31, 21, 26, 1, 23, 28, 2, 11, 32, 12, 1, 20, 10, 29, 17, 0, 13, 0, 1, 21, 0, 14, 32, 19, 32, 6, 28, 1, 2, 12, 32, 9, 7, 2, 6, 29, 15, 0, 32, 16, 13, 29, 3, 6, 3, 27, 6, 4, 5, 4, 4, 28, 31, 4, 17, 1, 0, 18, 12, 29, 2, 24, 28, 24, 4, 6, 30, 2, 20, 28, 31, 20, 19, 1, 32, 13, 9, 29, 6, 2, 26, 25, 0, 17, 0, 15, 32, 20, 21, 1, 27, 25, 1, 14, 32, 7, 28, 2, 2, 13, 8, 29, 32, 10, 17, 29, 30, 24, 1, 23, 20, 1, 32, 17, 3, 9, 23, 1, 14, 29, 18, 1, 12, 0, 0, 19, 11, 29, 25, 27, 2, 25, 23, 27, 22, 1, 31, 23, 3, 28, 9, 1, 30, 3, 20, 29, 0, 16, 14, 0, 7, 29, 2, 26, 2, 9, 8, 1, 32, 14, 26, 26, 6, 3, 11, 1, 1, 24, 27, 24, 1, 13, 2, 10, 32, 11, 29, 2, 10, 1, 31, 3, 5, 28, 1, 22, 32, 18, 3, 8, 18, 29, 16, 0, 32, 5, 29, 24, 32, 8
		],
		"shallow_tiles": [
			7, 3, 31, 6, 12, 1, 31, 19, 11, 28, 1, 17, 16, 28, 2, 22, 23, 26, 27, 2, 3, 24, 31, 8, 17, 2, 14, 1, 6, 5, 7, 28, 12, 28, 4, 10, 3, 23, 9, 3, 31, 15, 7, 5, 15, 1, 3, 12, 26, 2, 4, 26, 5, 27, 26, 24, 31, 11, 26, 23, 22, 26, 21, 2, 3, 11, 1, 15, 29, 23, 8, 28, 30, 4, 29, 4, 12, 2, 31, 18, 21, 27, 1, 16, 2, 23, 24, 25, 14, 28, 19, 28, 30, 20, 25, 25, 31, 17, 19, 2, 1, 19, 24, 2, 8, 3, 9, 2, 31, 14, 5, 7, 19, 27, 15, 28, 6, 27, 28, 23, 4, 8, 16, 1, 4, 27, 31, 13, 2, 19, 17, 28, 22, 27, 3, 10, 31, 9, 23, 2, 29, 22, 30, 5, 29, 3, 20, 27, 18, 2, 7, 27, 2, 20, 24, 26, 13, 28, 18, 28, 3, 26, 2, 14, 31, 10, 30, 6, 31, 7, 30, 21, 25, 24, 31, 16, 1, 18, 25, 2, 27, 3, 4, 7, 3, 25, 6, 6, 5, 6, 11, 2, 16, 2, 30, 22, 3, 14, 7, 4, 22, 2, 4, 9, 9, 28, 31, 12, 30, 19, 27, 23, 3, 13, 28, 3, 10, 28, 13, 1, 20, 2, 2, 21, 2, 15, 10, 2
		],
		"sand_tiles": [
			15, 27, 17, 27, 19, 4, 18, 4, 15, 2, 8, 5, 30, 13, 28, 5, 14, 2, 6, 7, 16, 3, 29, 12, 2, 17, 23, 25, 5, 11, 5, 13, 24, 24, 30, 16, 6, 26, 27, 22, 22, 25, 4, 15, 5, 14, 3, 18, 29, 20, 4, 22, 12, 27, 2, 18, 28, 22, 18, 26, 23, 3, 4, 12, 9, 4, 10, 3, 20, 26, 13, 3, 24, 3, 5, 8, 8, 6, 29, 7, 10, 4, 29, 21, 25, 3, 23, 24, 29, 16, 30, 15, 3, 22, 11, 3, 30, 17, 7, 6, 3, 15, 29, 19, 18, 27, 30, 8, 3, 21, 5, 26, 29, 13, 30, 18, 19, 3, 25, 23, 29, 15, 20, 3, 26, 3, 4, 13, 4, 11, 4, 24, 3, 16, 12, 3, 11, 27, 21, 26, 15, 3, 22, 4, 21, 4, 27, 4, 26, 4, 5, 10, 8, 26, 29, 6, 9, 27, 6, 8, 16, 27, 8, 4, 23, 4, 5, 9, 28, 4, 19, 26, 7, 7, 17, 3, 13, 2, 13, 27, 29, 18, 30, 9, 30, 14, 3, 20, 14, 27, 5, 25, 4, 23, 10, 27, 24, 23, 25, 22, 2, 16, 4, 14, 30, 10, 4, 25, 3, 19, 29, 11, 17, 4, 21, 25, 7, 26, 26, 22, 21, 3, 28, 21, 30, 11, 8, 27, 30, 7, 29, 5, 22, 3, 30, 12, 18, 3
		],
		"ground_tiles": [
			20, 25, 16, 9, 17, 20, 7, 25, 22, 19, 20, 7, 18, 19, 21, 6, 10, 7, 11, 22, 24, 14, 12, 17, 25, 15, 15, 4, 13, 20, 26, 12, 29, 17, 28, 10, 5, 24, 6, 23, 19, 13, 17, 13, 7, 22, 20, 14, 18, 10, 23, 19, 21, 15, 8, 12, 22, 12, 9, 9, 23, 9, 10, 14, 8, 18, 11, 15, 9, 19, 24, 21, 14, 8, 12, 8, 25, 16, 15, 13, 13, 13, 27, 6, 3, 17, 16, 7, 6, 14, 19, 18, 17, 6, 7, 15, 20, 21, 18, 5, 21, 8, 17, 24, 22, 7, 23, 6, 10, 9, 8, 25, 11, 4, 9, 20, 14, 19, 12, 7, 10, 19, 15, 10, 13, 6, 11, 26, 4, 17, 5, 20, 16, 20, 21, 17, 17, 17, 18, 22, 15, 19, 11, 19, 24, 9, 12, 20, 27, 20, 25, 4, 13, 25, 27, 10, 28, 13, 16, 11, 6, 18, 19, 6, 17, 10, 22, 17, 18, 17, 23, 20, 8, 7, 22, 11, 9, 6, 10, 5, 15, 24, 11, 8, 24, 16, 14, 7, 12, 19, 25, 13, 15, 6, 13, 18, 26, 10, 6, 21, 19, 15, 7, 16, 20, 8, 18, 8, 16, 24, 21, 13, 8, 14, 9, 15, 23, 11, 10, 12, 8, 20, 9, 17, 14, 14, 12, 10, 10, 22, 15, 15, 13, 11, 26, 21, 5, 15, 6, 12, 4, 20, 19, 20, 7, 9, 20, 23, 21, 22, 22, 5, 11, 6, 9, 26, 14, 17, 10, 17, 15, 20, 13, 4, 27, 17, 26, 6, 4, 19, 5, 18, 16, 22, 6, 25, 17, 23, 20, 4, 18, 20, 14, 24, 10, 24, 11, 21, 24, 11, 12, 22, 25, 10, 13, 23, 28, 17, 27, 12, 28, 15, 29, 14, 16, 13, 6, 16, 21, 24, 19, 8, 17, 8, 7, 21, 22, 23, 18, 15, 23, 22, 8, 9, 22, 9, 23, 12, 15, 26, 11, 10, 24, 18, 14, 5, 12, 13, 25, 19, 13, 16, 26, 8, 27, 5, 28, 6, 6, 11, 19, 17, 7, 18, 20, 10, 18, 6, 21, 11, 9, 13, 23, 5, 10, 10, 8, 22, 9, 23, 14, 12, 12, 4, 10, 20, 25, 20, 15, 9, 13, 9, 11, 25, 26, 19, 19, 22, 7, 11, 5, 23, 20, 17, 16, 17, 21, 20, 9, 24, 14, 23, 15, 22, 24, 6, 12, 25, 27, 19, 25, 7, 28, 20, 27, 9, 5, 16, 20, 24, 16, 8, 19, 5, 17, 21, 22, 18, 20, 6, 18, 18, 21, 7, 10, 6, 11, 23, 24, 13, 12, 16, 25, 8, 15, 5, 13, 21, 28, 19, 26, 15, 27, 14, 28, 9, 16, 15, 6, 22, 19, 10, 17, 14, 7, 23, 22, 21, 20, 13, 18, 13, 23, 16, 8, 11, 22, 15, 9, 10, 23, 14, 8, 17, 11, 12, 24, 20, 14, 11, 12, 15, 25, 17, 13, 14, 27, 7, 16, 6, 6, 9, 19, 19, 17, 7, 7, 12, 20, 20, 21, 9, 17, 25, 22, 6, 23, 7, 10, 8, 8, 24, 11, 5, 9, 21, 14, 18, 12, 6, 10, 18, 15, 11, 13, 7, 26, 17, 4, 16, 19, 24, 5, 21, 20, 19, 16, 19, 21, 18, 17, 18, 18, 25, 14, 21, 15, 16, 11, 16, 24, 8, 27, 21, 25, 5, 13, 26, 27, 11, 28, 12, 16, 10, 19, 7, 17, 11, 7, 24, 22, 16, 18, 16, 23, 21, 21, 5, 22, 10, 9, 7, 15, 25, 11, 9, 24, 15, 14, 6, 12, 18, 25, 14, 15, 7, 13, 19, 26, 13, 28, 11, 29, 10, 6, 20, 19, 12, 17, 12, 7, 17, 20, 15, 18, 11, 23, 18, 21, 14, 8, 13, 22, 13, 9, 8, 23, 8, 10, 15, 8, 19, 11, 14, 9, 18, 24, 22, 14, 9, 12, 9, 15, 12, 13, 12, 26, 20, 6, 15, 19, 21, 17, 5, 7, 14, 20, 22, 21, 23, 11, 7, 14, 16, 10, 16, 15, 21, 13, 5, 4, 18, 5, 19, 16, 21, 6, 24, 21, 16, 17, 16, 18, 23, 15, 18, 11, 18, 24, 10, 12, 21, 25, 11, 13, 24, 28, 16, 27, 13, 28, 14, 16, 12, 6, 19, 19, 9, 17, 9, 22, 22, 18, 14, 23, 23, 8, 8, 22, 8, 9, 5, 23, 13, 11, 11, 24, 17, 14, 4, 12, 12, 25, 12, 13, 17, 26, 11, 29, 8, 6, 10, 19, 14, 7, 19, 20, 9, 18, 9, 16, 25, 21, 12, 8, 15, 9, 14, 23, 10, 10, 13, 8, 21, 9, 16, 14, 15, 12, 11, 10, 23, 25, 21, 15, 14, 13, 10, 26, 18, 6, 13, 4, 21, 19, 23, 7, 8, 20, 16, 16, 16, 21, 21, 9, 25, 14, 22, 15, 23, 12, 24, 27, 16, 26, 7, 5, 17, 16, 23, 17, 22, 20, 5, 18, 21, 14, 25, 10, 25, 11, 20, 24, 12, 14, 3, 12, 23, 25, 9, 13, 22, 28, 18, 26, 14, 27, 15, 28, 8, 16, 14, 6, 17, 19, 11, 17, 15, 7, 20, 22, 20, 20, 12, 18, 12, 23, 17, 8, 10, 22, 14, 9, 11, 23, 15, 8, 16, 11, 13, 24, 19, 14, 10, 12, 14, 25, 18, 13, 15, 26, 9, 28, 7, 19, 16, 7, 13, 20, 11, 18, 7, 21, 10, 17, 26, 9, 12, 10, 11, 8, 23, 9, 22, 14, 13, 12, 5, 10, 21, 15, 8, 13, 8, 11, 24, 26, 16, 5, 12, 19, 25, 7, 10, 5, 22, 20, 18, 16, 18, 21, 19, 17, 19, 22, 24, 18, 24, 14, 20, 15, 17, 11, 17, 24, 7, 27, 18, 25, 6, 26, 5, 27, 8, 16, 5, 16, 4, 29, 9, 24, 5, 24, 4, 12, 26, 14, 26, 16, 26, 10, 26
		]
	},
	{
		"deep_tiles": [
			58, 42, 39, 37, 27, 43, 28, 42, 27, 46, 54, 38, 31, 55, 58, 41, 38, 58, 44, 59, 51, 37, 54, 37, 35, 38, 35, 57, 58, 51, 43, 36, 32, 57, 39, 58, 29, 53, 40, 59, 53, 37, 28, 48, 56, 56, 59, 48, 30, 54, 46, 59, 40, 36, 52, 37, 45, 36, 34, 57, 49, 59, 54, 57, 50, 58, 28, 51, 59, 42, 59, 45, 34, 38, 42, 59, 42, 36, 47, 36, 28, 41, 27, 47, 58, 40, 43, 59, 58, 53, 27, 44, 49, 36, 36, 38, 35, 58, 58, 50, 57, 38, 32, 56, 39, 59, 56, 55, 59, 49, 33, 38, 51, 58, 57, 54, 29, 54, 28, 50, 59, 43, 55, 38, 59, 46, 41, 59, 48, 59, 28, 40, 27, 48, 55, 56, 29, 39, 31, 38, 39, 36, 44, 36, 58, 52, 27, 42, 27, 45, 29, 40, 36, 37, 57, 39, 36, 58, 33, 57, 41, 36, 46, 36, 51, 36, 45, 59, 30, 39, 59, 50, 57, 53, 38, 37, 57, 55, 37, 58, 52, 58, 29, 52, 53, 57, 48, 36, 28, 49, 59, 47, 56, 38, 30, 55, 37, 37, 58, 39, 31, 56, 47, 59, 53, 58, 50, 59, 55, 57, 50, 36, 31, 39, 29, 51, 59, 44, 32, 38
		],
		"shallow_tiles": [
			34, 39, 30, 51, 42, 37, 29, 41, 28, 47, 57, 49, 33, 39, 58, 44, 36, 57, 32, 54, 43, 58, 41, 37, 57, 42, 56, 53, 29, 42, 57, 50, 36, 39, 57, 52, 38, 57, 52, 57, 29, 47, 51, 57, 53, 38, 29, 48, 57, 40, 56, 40, 30, 53, 37, 39, 41, 58, 39, 38, 50, 57, 28, 46, 58, 47, 32, 40, 36, 56, 44, 37, 44, 58, 51, 38, 56, 52, 30, 41, 29, 43, 35, 39, 57, 51, 31, 53, 43, 37, 33, 56, 52, 56, 46, 37, 40, 58, 55, 54, 45, 58, 58, 49, 46, 58, 45, 37, 34, 56, 54, 56, 53, 56, 48, 37, 53, 39, 50, 38, 29, 49, 57, 41, 56, 39, 30, 52, 42, 58, 40, 38, 47, 58, 47, 37, 54, 55, 28, 45, 50, 37, 29, 50, 58, 46, 32, 39, 58, 43, 28, 43, 52, 38, 49, 37, 30, 40, 54, 39, 58, 45, 31, 54, 38, 38, 32, 55, 37, 57, 40, 57, 30, 50, 56, 54, 31, 40, 35, 56, 58, 48, 55, 55, 49, 57, 39, 57, 55, 39, 33, 55, 40, 37, 49, 58, 48, 58, 28, 44, 57, 43, 37, 38
		],
		"sand_tiles":[
			54, 53, 30, 43, 55, 41, 32, 41, 56, 44, 43, 39, 44, 38, 34, 55, 46, 39, 40, 56, 49, 39, 31, 41, 31, 52, 55, 53, 41, 38, 53, 54, 30, 48, 31, 51, 57, 47, 55, 51, 41, 57, 56, 50, 36, 55, 48, 57, 47, 39, 48, 38, 30, 47, 50, 39, 36, 40, 40, 39, 47, 57, 52, 55, 30, 42, 33, 40, 56, 43, 38, 40, 37, 40, 32, 53, 37, 55, 34, 54, 46, 38, 45, 57, 52, 39, 31, 42, 38, 39, 34, 40, 38, 56, 37, 56, 41, 39, 53, 55, 29, 44, 57, 44, 35, 55, 56, 49, 55, 52, 33, 53, 49, 56, 48, 56, 39, 56, 52, 40, 30, 46, 31, 49, 39, 39, 46, 57, 51, 55, 33, 54, 45, 38, 50, 56, 54, 40, 53, 40, 33, 41, 56, 42, 32, 52, 42, 57, 44, 57, 51, 39, 35, 40, 57, 48, 55, 40, 43, 38, 44, 39, 43, 57, 49, 38, 29, 45, 57, 45, 56, 48, 30, 49, 31, 50, 29, 46, 57, 46, 41, 56, 56, 51, 51, 56, 42, 38, 47, 38, 54, 54, 30, 44, 56, 41
		],
		"ground_tiles": [
			43, 45, 46, 40, 44, 56, 49, 55, 47, 43, 45, 55, 48, 42, 37, 43, 51, 50, 39, 53, 52, 51, 42, 40, 53, 48, 55, 46, 56, 47, 46, 49, 44, 49, 47, 50, 45, 46, 50, 55, 48, 51, 35, 48, 49, 48, 36, 45, 50, 45, 37, 50, 35, 54, 38, 51, 41, 44, 39, 44, 52, 52, 42, 49, 40, 49, 54, 42, 31, 48, 43, 43, 33, 50, 46, 54, 44, 42, 34, 51, 45, 41, 48, 44, 49, 43, 50, 42, 37, 45, 41, 55, 39, 43, 42, 46, 40, 42, 31, 47, 32, 46, 48, 53, 44, 53, 42, 55, 38, 55, 51, 45, 54, 46, 55, 49, 43, 47, 46, 42, 44, 46, 49, 53, 45, 53, 48, 40, 35, 43, 49, 47, 36, 42, 37, 41, 38, 44, 51, 52, 41, 43, 39, 55, 52, 49, 42, 42, 40, 54, 53, 46, 31, 43, 32, 42, 56, 45, 46, 51, 34, 52, 47, 44, 45, 44, 48, 49, 35, 50, 36, 51, 50, 47, 37, 48, 36, 53, 41, 50, 39, 46, 42, 51, 40, 47, 32, 51, 33, 48, 46, 56, 44, 40, 34, 45, 45, 39, 49, 41, 38, 42, 41, 53, 37, 53, 42, 56, 40, 40, 51, 40, 53, 42, 32, 44, 33, 43, 34, 42, 47, 40, 51, 47, 52, 46, 54, 48, 43, 49, 33, 52, 46, 44, 44, 44, 45, 51, 35, 45, 49, 45, 50, 48, 38, 46, 51, 54, 41, 41, 39, 49, 40, 52, 53, 44, 54, 41, 55, 42, 43, 40, 33, 47, 46, 53, 47, 46, 45, 42, 48, 47, 36, 49, 50, 41, 37, 46, 41, 48, 39, 40, 42, 45, 40, 45, 31, 44, 32, 49, 34, 47, 47, 53, 43, 53, 51, 42, 52, 43, 54, 45, 43, 44, 46, 41, 49, 54, 47, 42, 45, 54, 48, 43, 37, 42, 51, 49, 39, 52, 52, 44, 42, 41, 53, 51, 54, 50, 55, 45, 43, 51, 46, 46, 44, 50, 47, 49, 45, 49, 50, 52, 35, 47, 49, 51, 36, 46, 50, 50, 35, 53, 38, 48, 41, 47, 39, 51, 52, 53, 40, 50, 54, 43, 43, 42, 33, 45, 46, 55, 44, 43, 34, 48, 47, 56, 45, 40, 48, 45, 49, 42, 50, 43, 37, 44, 38, 41, 41, 54, 39, 42, 37, 54, 42, 47, 40, 43, 53, 53, 31, 46, 32, 47, 34, 41, 47, 55, 43, 55, 48, 54, 44, 54, 42, 52, 38, 52, 51, 44, 52, 41, 54, 47, 55, 48, 43, 46, 46, 43, 44, 47, 49, 52, 45, 52, 48, 41, 35, 42, 49, 46, 36, 43, 38, 45, 51, 51, 41, 42, 39, 54, 52, 50, 42, 43, 40, 55, 53, 49, 55, 47, 32, 43, 46, 48, 44, 48, 34, 53, 47, 51, 45, 47, 50, 54, 48, 50, 35, 49, 49, 49, 36, 44, 50, 44, 37, 51, 38, 50, 36, 54, 41, 45, 39, 45, 42, 48, 40, 48, 33, 51, 44, 41, 34, 50, 49, 40, 38, 43, 41, 52, 37, 52, 40, 41, 32, 45, 33, 42, 34, 43, 48, 52, 44, 52, 42, 54, 38, 54, 51, 46, 52, 47, 54, 49, 55, 50, 43, 48, 46, 45, 44, 45, 45, 50, 48, 39, 35, 44, 49, 44, 36, 41, 50, 49, 38, 47, 51, 53, 41, 40, 39, 48, 52, 48, 40, 53, 53, 47, 33, 46, 46, 50, 47, 45, 45, 45, 48, 48, 35, 51, 36, 50, 50, 46, 37, 49, 36, 52, 41, 51, 39, 47, 42, 50, 40, 46, 32, 50, 33, 49, 34, 44, 47, 52, 43, 52, 51, 41, 54, 52, 53, 43, 47, 41, 51, 48, 52, 45, 53, 50, 54, 51, 55, 44, 43, 50, 46, 47, 44, 51, 47, 48, 45, 48, 50, 53, 35, 46, 49, 50, 36, 47, 50, 51, 35, 52, 38, 49, 41, 46, 39, 50, 52, 54, 42, 39, 40, 51, 53, 45, 30, 45, 55, 43, 43, 41, 33, 44, 46, 52, 34, 49, 47, 47, 45, 43, 48, 46, 36, 48, 50, 40, 37, 47, 41, 49, 39, 41, 42, 44, 40, 44, 53, 52, 31, 45, 32, 48, 34, 46, 47, 54, 43, 54, 48, 55, 44, 55, 42, 53, 38, 53, 51, 43, 52, 42, 53, 41, 54, 44, 35, 41, 56, 46, 45, 56, 43, 56
		]
	}
]
}
